2,3
3,1
#####
#   #
# B #
#   #
#####