#####
#  O#
# B #
# P #
#####