2,3
2,4 2,3 5,5
#####
#   ##########
# B          #
#   #### ### #
#   #### ### #
#        ### #
###   ###### #
  #   ###### #
  #   ###### #
  #          #
  ############