#######
#OPB  #
###   #
# # B #
#O B ###
#     O#
########