2,2
1,2 5,3 1,5 4,5 3,6 6,6 4,7
  #####
###   #
#  B  #
### B #
# ##B #
# #   ##
#B BBB #
#      #
########