  #####
###   #
#OPB  #
### BO#
# ##B #
#O# O ##
#B bBBO#
#   O  #
########